E T C E G E B G C T D H E B C D B C J T                                                                                                                                                                                                                                                                                                                              
B I D J H H I E C H H J G E B H D T J B                                                                                                                                                                                                                                                                                                                              
C H J I G E I B D B E C I E T G G D H I                                                                                                                                                                                                                                                                                                                              
G H D E C E B T T G J B D H I D J E D C                                                                                                                                                                                                                                                                                                                              
J G T B B D T T D E T T C T G E D D E B                                                                                                                                                                                                                                                                                                                              
C I B I B C J B H G H T T D J J G B D I                                                                                                                                                                                                                                                                                                                              
D T G E E J J D T C T G J B T B E C J J                                                                                                                                                                                                                                                                                                                              
E J D H H J T I B H I C T H H B B G C C                                                                                                                                                                                                                                                                                                                              
D E T D G B B I D I D D B D C D H I H G                                                                                                                                                                                                                                                                                                                              
I T B D D I G C E I J I J H E J J T B G                                                                                                                                                                                                                                                                                                                              
I C E D C E T G E C E D I H D D D G J I                                                                                                                                                                                                                                                                                                                              
E I C G I G E E J C E H H B I G G I B J                                                                                                                                                                                                                                                                                                                              
H T I B C G J C D B G D T D T J J J E G                                                                                                                                                                                                                                                                                                                              
T G G B I I G H I H H E E T T E T T C B                                                                                                                                                                                                                                                                                                                              
H B B H G B G D T I H H D E J B D G D D                                                                                                                                                                                                                                                                                                                              
J B D G D B I J C G I I G C J I E I E G                                                                                                                                                                                                                                                                                                                              
C C H J T T B T T I B E H J C E I E D D                                                                                                                                                                                                                                                                                                                              
C G T D T I T T E B H E T H B H D D E C                                                                                                                                                                                                                                                                                                                              
T I I D E D B H T D T J E T D G B C J C                                                                                                                                                                                                                                                                                                                              
T T E J B G D J H E B D T T D E I H J G                                                                                                                                                                                                                                                                                                                              
