T A E G G B T E D
C E T T E B H T E
H G D C I D D D T
C G H B I H C J H
A T T A C A A A G
T E H I A B T T C
G J C T B B B I A
I T H D I H E H A
D I D D D I J D J
